+--------------+
|x             |
|x             |
|x     x       |
+-------       |
|              |
|      S       |
|              |
|              |
|              |
|              |
+--------------+