+--------------+
|              |
|              |
|              |
|              |
|              |
|      S       |
|              |
|              |
|              |
|              |
+--------------+