+-----+--+-----+
+-----+SC+-----+
+-----+CC+-----+
+-----+CC+-----+
+++++-+P-+-+++++
|||||  C   |||||
|||||      |||||
|||||      |||||
+++++------+++++
|CCCCCCCCCCCCCC|
|CCCCCCCCCCCCCC|
+--------------+