+-----+--+-----+
|     |SC|     |
|     |CC|     |
|     |CC|     |
|      CC      |
|      CC      |
|              |
|              |
|              |
|              |
|              |
+--------------+