+--------------+
|      Z       |
| x--      --x |
| |          | |
|   x--  --x   |
|     CCCCC    |
|   | CCSCC|   |
|   +--CC--+   |
| |    CC    | |
| x--      --x |
|       P      |
+--------------+