+--------------+
|      Z       |
| x--      --x |
| |    CC    | |
|   x--CC--x   |
|  CCCCCCCCCC  |
|   | CCSCC|   |
|   +--CC--+   |
| |    CC    | |
| x--      --x |
|       P      |
+--------------+