+--------------+
|              |
| x      P   x |
|              |
|     x  x     |
|     +--+     |
|     CCSCC    |
|     +--+     |
|     x  x     |
| x   Z      x |
|              |
+--------------+